
mapInitX = 5
mapInitY = 5
mapInitAng  = 60
map ={
	{1, 1, 1, 1, 1, 1, 1, 1, 1, 1, 1},
    {1, 0, 0, 0, 0, 0, 0, 0, 0, 0, 1},
    {1, 0, 0, 1, 1, 1, 1, 1, 1, 1, 1},
    {1, 0, 0, 0, 0, 0, 0, 0, 0, 0, 1},
    {1, 0, 0, 0, 0, 0, 0, 0, 0, 0, 1},
    {1, 1, 1, 1, 1, 1, 1, 1, 0, 0, 1},
    {1, 0, 0, 0, 0, 0, 0, 0, 0, 0, 1},
    {1, 0, 0, 0, 0, 0, 0, 0, 0, 0, 1},
    {1, 0, 1, 1, 1, 1, 1, 1, 1, 1, 1},
    {1, 0, 1, 0, 0, 0, 0, 0, 0, 0, 1},
    {1, 0, 1, 0, 0, 0, 1, 1, 1, 0, 1},
	{1, 0, 0, 0, 0, 1, 1, 0, 1, 0, 1}, 
	{1, 0, 1, 0, 0, 1, 0, 0, 1, 0, 1},  
	{1, 0, 1, 1, 1, 1, 1, 0, 0, 0, 1},  
	{1, 0, 1, 1, 0, 0, 1, 0, 1, 0, 1}, 
	{1, 0, 1, 1, 0, 0, 1, 0, 1, 0, 1}, 
	{1, 0, 0, 1, 0, 0, 0, 0, 1, 0, 1}, 
	{1, 1, 1, 1, 0, 0, 1, 1, 1, 1, 1},  	
  }
  
map_width  = 11
map_height = table.getn(map)
